@@@@@@@@@@@@@@@@@@@@@@@@@@@@@@
@S@@@@@@@@@@@################@
@#@@@@@@@@@@@@#@@@@@#@@@@@@@#@
@##############@@@@@#@@@@@@@#@
@@@@@#@@@@@@@@#@@@@@#@@@@@@@#@
@@@@@#@@@@@@@@###############@
@##############@@@@#@@@@@@@@#@
@@@@@#@@@@@@@@#@@@@#@@@@@@@@#@
@@@@@#@@@@@@@@#@@@@#@@@@@@@@#@
@##############@@@@#########E@
@#@@@@#@@@@@@@#@@@@@#@@@@@@@#@
@#@@@@#@@@@@@@#@@@@@#@@@@@@@#@
@######@@@@@@@#@@@@@#@@@@@@@#@
@#@@@@#@@@@@@@###############@
@@@@@@@@@@@@@@@@@@@@@@@@@@@@@@
