@@@@@@@@@@@@@@@@@@@@@@@@@@@@@@
@S###########################@
@#@@@@@@@@@@@@@#@@@#@@@@@@@@#@
@#@@@@@@@@@@@@@#@@@##########@
@#@@@@@@@#######@@@@@@@@#@@@@@
@#@@@@@@@#@@@@@#@@@@@@@@#@@@@@
@#########@@@@@#@@@@@@@#####@@
@#@@@@@@@#@@@@@#@@@@@@@#@@@#@@
@#@@@@@@@#@@@@@#@@@@@@@#@@@#@@
@#@@@@@@@#@@@@@#############@@
@#########@@@@@#@@@@@@@@@@#@@@
@#@@@@@@@#@@@@@#@@@@@@@@@@#@@@
@#@@@@@@@#@@@@@#@@@@@@@@@@#@@@
@#@@@@@@@###################E@
@@@@@@@@@@@@@@@@@@@@@@@@@@@@@@
